R 512 256
NO ./textures/north.xpm
SO ./textures/brick.xpm
WE ./textures/brick.xpm
EA ./textures/brick.xpm

F 50,50,0
C 0,50,50

1111111
1000001
100W001
1000001
1111111
