NO ./textures/brick.xpm
SO ./textures/grass.xpm
WE ./textures/flat.xpm
EA ./textures/north.xpm

F  50,50,0
C 0,50,50

1111111
1000001
1000001
10100W1
1000001
1000001
1111111
