R 1024 512
NO ./path_to_the_north_texture
SO ./path_to_the_south_texture
WE ./path_to_the_west_texture
EA ./path_to_the_east_texture

S ./path_to_the_sprite_texture
F 0,255,0
C 0,0,255

1111111111
1000000001
1000000001
1000001001
1000E00001
1000000001
1000000001
1000000001
1000000001
1111111111