R 512 256
NO ./textures/north.xpm
SO ./textures/brick.xpm
WE ./textures/brick.xpm
EA ./textures/brick.xpm

F 50,50,0
C 0,50,50

111111
100001
100001111111
1E0000000001
110111111101
110111111101
110111111101
100000000001
111111111111