R 1024 512
NO ./textures/wood.xpm
SO ./textures/brick.xpm
WE ./textures/brick.xpm
EA ./textures/brick.xpm

S ./path_to_the_sprite_texture
F 50,50,0
C 0,50,50

1111111111
1000000001
1000N00001
1000000001111111
1000000000000001
1000000001111111
1000000001
1000000001
1000000001
1111111111