NO ./textures/brick.xpm
SO ./textures/grass.xpm
WE ./textures/flat.xpm
EA ./textures/north.xpm

F  50,50,0
C 0,50,255

    1111111
    1000001
    1000001
    1010001
    1000N01
    1000001
    1111111