R 512 256
NO ./textures/brick.xpm
SO ./textures/grass.xpm
WE ./textures/folder-blue.xpm
EA ./textures/north.xpm

F 50,50,0
C 0,50,50

1111111
1000001
100N001
1000001
1001001
1000001
1111111
