WE ./path_to_the_west_texture
SO ./path_to_the_south_texture
EA ./path_to_the_east_texture

C 225,30,0
NO ./path_to_the_north_texture

F 220,100,0
R 1920 1080

1111111111
10000N0001
1111111111