
1111111111
1000000001
10N0000001
10000000011111111
10000000000000001
10000000011111101
10000000011111101
10000001011111101
10000000011111111
1111111111

NO ./textures/north.xpm
SO ./textures/brick.xpm
WE ./textures/brick.xpm
EA ./textures/brick.xpm

F 50,50,0
C 0,50,50
